border_size=1
usage=map

Mm          , Mm          , Mm          , Mm          , Mm          , Mm          , Mm          , Mm          , Gs^Fp       , Gs^Fp       , Gs^Fp       , Gg          , Gg          , Gg          , Gg          , Gg          , Gg          , Gg          , Gg          , Gg          , Gg          , Gg          , Gg          , Mm          , Mm          , Mm          , Gg          , Gg          , Gg          , Gg          , Re          , Re          , Gg          , Mm          , Hh          , Mm          , Hh          , Hh          , Hh          , Hh          , Gg          , Gg          
Mm          , Mm          , Mm          , Mm          , Mm          , Mm          , Mm          , Mm          , Gs^Fp       , Gs^Fp       , Gs^Fp       , Gg          , Gg          , Gg          , Gg          , Gg          , Gg          , Gg          , Gg          , Gg          , Gg          , Gg          , Gg          , Mm          , Mm          , Mm          , Gg          , Gg          , Gg          , Gg          , Gg          , Gg          , Gg          , Mm          , Hh^Vhh      , Mm          , Hh          , Hh          , Hh          , Hh          , Gg          , Gg          
Mm          , Mm          , Mm          , Mm          , Hh          , Hh          , Hh          , Hh          , Hh          , Gs^Fp       , Gs^Fp       , Gg          , Gg          , Gg          , Gs^Fds      , Gg          , Gg          , Gg          , Re          , Gg          , Gg          , Gg          , Gg          , Gs^Fms      , Gs^Fms      , Gs^Fds      , Gg          , Gg          , Gg          , Gg          , Gg          , Gg          , Gs^Fms      , Hh          , Hh          , Hh          , Hh          , Hh          , Gs^Fp       , Gg          , Ww          , Ww          
Hh          , Hh          , Hh          , Hh          , Hh          , Hh          , Hh          , Hh          , Gs^Fp       , Gs^Fp       , Gg          , Gg          , Gg          , Gs^Fds      , Gs^Fds      , Gs^Fds      , Gs^Fms      , Gs^Fms      , Gs^Fms      , Rd          , Gs^Fms      , Gg          , Gs^Fds      , Gg          , Gg          , Gg          , Hh          , Gg          , Gg          , Gg          , Gg          , Gs^Fp       , Gs^Fms      , Gs^Fds      , Gs^Fds      , Gs^Fds      , Gs^Fms      , Gs^Fms      , Gg          , Ww          , Ww          , Ww          
Hh          , Hh          , Hh          , Hh          , Gg          , Gs^Fp       , Gs^Fp       , Gs^Fp       , Gs^Fp       , Gs^Fp       , Gg          , Gg          , Gg          , Gs^Fds      , Gs^Fds      , Gs^Fds      , Gs^Fms      , Gs^Fds      , Gs^Fds      , Gs^Fds      , Gs^Fds      , Gs^Fms      , Gs^Fds      , Gs^Fms      , Gg          , Rd          , Hh          , Gs^Fp       , Gg          , Gg          , Gg          , Gs^Fp       , Gs^Fms      , Gs^Fds      , Gg          , Gs^Fds      , Gg          , Gg          , Ww          , Ww          , Ww          , Ww          
Hh          , Hh          , Ww          , Gg          , Ww          , Gg          , Ww          , Gg          , Ww          , Gg          , Ww          , Gg          , Gg          , Gg          , Ww          , Gs^Fms      , Gs^Fms      , Gs^Fms      , Gg          , Gs^Fds      , Gg          , Gs^Fms      , Gs^Fms      , Gs^Fms      , Gg          , Gs^Fms      , Gs^Fms      , Gs^Fp       , Gg          , Gg          , Gg          , Gg          , Gg          , Gg          , Gg          , Rd          , Ww          , Ww          , Ww          , Ww          , Ww          , Ww          
Ww          , Ww          , Wo          , Ww          , Wo          , Ww          , Wo          , Ww          , Wo          , Ww          , Wo          , Ww          , Ww          , Ww          , Ww          , Ww          , Ww          , Ww          , Ww          , Ww          , Ww          , Gg          , Gg          , Gg          , Gg          , Gg          , Ww          , Gg          , Ww          , Gg          , Gs^Fds      , Gg          , Gg          , Gs^Fds      , Wwf         , Ww          , Ww          , Ww          , Ww          , Ww          , Ww          , Ww          
Wo          , Wo          , Wo          , Wo          , Wo          , Wo          , Wo          , Wo          , Wo          , Wo          , Wo          , Wo          , Wo          , Wo          , Wo          , Wo          , Wo          , Ww          , Wo          , Wo          , Wo          , Ww          , Ww          , Ww          , Ww          , Ww          , Wo          , Ww          , Wo          , Ww          , Ww          , Ww          , Wwf         , Ww          , Wwf         , Wwf         , Ww          , Ww          , Ww          , Ww          , Ww          , Ww          
Wo          , Wo          , Ww          , Wo          , Ww          , Wo          , Ww          , Wo          , Ww          , Wo          , Ww          , Wo          , Wo          , Wo          , Wo          , Wo          , Wo          , Wo          , Gs^Fms      , Gs^Fms      , Gs^Fms      , Wo          , Wo          , Wo          , Wo          , Wo          , Wo          , Wo          , Wo          , Wo          , Wo          , Ww          , Ww          , Wwf         , Ww          , Wwf         , Ww          , Ww          , Ww          , Ww          , Ww          , Ww          
Ww          , Ww          , Hh          , Ww          , Gg          , Ww          , Gs^Fms      , Ww          , Gs^Fms      , Ww          , Ww          , Ww          , Ww          , Ww          , Ww          , Ww          , Ww          , Wo          , Wo          , Gs^Fms      , Wo          , Gg          , Wo          , Wo          , Wo          , Wo          , Ww          , Wo          , Ww          , Ww          , Ww          , Ww          , Ww          , Wwf         , Wwf         , Wwf         , Ww          , Ww          , Ww          , Ww          , Ww          , Ww          
Hh          , Hh          , Hh          , Gg          , Gs          , Gg          , Gs          , Gs^Fms      , Gs          , Gs^Fds      , Gs^Fms      , Gs^Fms      , Gs^Fms      , Gg          , Gg          , Gg          , Gg          , Ww          , Ww          , Ww          , Ww          , Ww          , Ww          , Ww          , Ww          , Ww          , Ww          , Ww          , Ww          , Ww          , Ww          , Ww          , Wwf         , Wwf         , Wwf         , Wwf         , Wwf         , Ww          , Ww          , Ww          , Ww          , Ww          
Hh          , Hh          , Gs^Fds      , Gs          , Re          , Gs          , Re          , Gs          , Re          , Gs^Fds      , Gs^Fds      , Gs^Fds      , Gs^Fds      , Re^Gvs      , Re^Gvs      , Re^Gvs      , Re^Gvs      , Gg          , Gg          , Gg          , Gg          , Gg          , Gg          , Gg^Vh       , Gg          , Gg          , Gg          , Ww          , Gg          , Ww          , Ce          , Ww          , Gg          , Ww          , Wwf         , Wwf         , Ww          , Ww          , Gg          , Gg          , Gg          , Gg          
Gs          , Gs          , Re          , Gs          , Re          , Re          , Rd          , Re          , Re          , Re          , Gs          , Gs^Fds      , Gg          , Re^Gvs      , Re^Gvs      , Re^Gvs      , Gs^Fds      , Gs^Fds      , Gs^Fds      , Re^Gvs      , Re^Gvs      , Re^Gvs      , Gg          , Re^Gvs      , Gg^Vh       , Re^Gvs      , Gg          , Gg          , Ce          , Ce          , Ce          , Ce          , Re          , Gg          , Gg          , Ww          , Gg          , Gg          , Gs^Fds      , Re          , Re          , Gg          
Gs          , Re          , Rd          , Re          , Re          , Re          , Re          , Rd          , Re          , Re          , Re          , Re          , Gs          , Gg          , Gg          , Re^Gvs      , Gs^Fds      , Gs^Fds      , Gs^Fds      , Re^Gvs      , Gg          , Gg          , Re          , Gg          , Re          , Gg          , Re          , Ce          , Re          , Ce          , Ce          , Ce          , Ce          , Ce          , Gg          , Gg          , Re          , Gs^Fds      , Rd          , Gs^Fds      , Re          , Re          
Gs          , Re          , Re          , Re          , Gs^Fms      , Re          , Rd          , Re          , Re          , Rd          , Rd          , Re          , Re          , Gs          , Gg          , Gg          , Gg          , Gs^Fds      , Re          , Gg          , Re          , Re          , Gs^Fds      , Re          , Gg          , Re          , Gg          , Re          , Gg          , Ce          , Ce          , Ce          , Gg          , Gg          , Gg          , Re          , Re          , Rd          , Rd          , Rd          , Re          , Re          
Gg          , Ss          , Ww          , Gs^Fms      , Ss          , Gs^Fms      , Re          , Re          , Re          , Re          , Re          , Rd          , Re          , Gs          , Re          , Re          , Re          , Re          , Gg          , Re          , Gg          , Gs^Fds      , Gs^Fds      , Gs^Fds      , Gg          , Re          , Gg          , Gg          , Re^Gvs      , Re^Gvs      , Gs^Fds      , Gs^Fds      , Gs^Fds      , Gs^Fds      , Gs^Fds      , Gs^Fms      , Gs^Fds      , Rd          , Rd          , Rd          , Re          , Re          
Gg          , Ss          , Ss          , Ww          , Re          , Re          , Re          , Gs          , Re          , Rd          , Re          , Re          , Re          , Re          , Gs          , Gg          , Gg          , Gg          , Gg          , Gg          , Gg          , Gs^Fds      , Gs^Fds      , Gs^Fds      , Gg          , Re          , Gg          , Re^Gvs      , Re^Gvs      , Gs^Fds      , Gg          , Gs^Fds      , Gs^Fds      , Gs^Fds      , Gs^Fms      , Gg^Vh       , Gs^Fms      , Re          , Gs^Fms      , Re          , Re          , Gg          
Gg          , Gs          , Gs          , Ss          , Re          , Rd          , Rd          , Re          , Re          , Re          , Re          , Re          , Rd          , Re          , Gs^Fds      , Gs^Fds      , Gs^Fds      , Gs^Fds      , Gg          , Gg          , Gg          , Gg          , Gg          , Gg          , Re          , Re          , Gs^Fds      , Re^Gvs      , Gs^Fds      , Gs^Fds      , Gs^Fds      , Gs^Fds      , Gs^Fds      , Gs^Fds      , Gs^Fds      , Gs^Fds      , Gg          , Gs^Fms      , Gs^Fms      , Gs^Fds      , Gg          , Gg          
Gg          , Gs          , Gs          , Re          , Re          , Rd          , Rd          , Re          , Gs^Fds      , Re          , Rd          , Re          , Rd          , Re          , Gs^Fds      , Gs^Fds      , Gs^Fds      , Gg          , Gs^Fds      , Gg          , Gg          , Gg          , Gs^Fds      , Gg          , Re          , Gs^Fds      , Gs^Fds      , Gs^Fds      , Gs^Fds      , Gs^Fds      , Gs^Fds      , Gs^Fds      , Gs^Fds      , Gs^Fms      , Gg          , Gg          , Gg          , Gs^Fds      , Gs^Fms      , Gs^Fds      , Gg          , Gg          
Gg          , Gg          , Gs          , Re          , Re          , Re          , Re          , Re          , Gs          , Re          , Re          , Re          , Rd          , Re          , Gs          , Gs^Fds      , Gg          , Gg          , Gs^Fds      , Gg          , Gg          , Gs^Fds      , Gs^Fms      , Gs^Fms      , Re          , Gs^Fds      , Gs^Fds      , Gs^Fds      , Hh          , Gs^Fds      , Gg          , Gs^Fds      , Gs^Fds      , Gs^Fds      , Gs^Fds      , Gs^Fds      , Gs^Fms      , Gg          , Gg          , Gg          , Gg          , Gg          
Gg          , Gg          , Gg          , Gs          , Gs^Fds      , Gs          , Gs^Fds      , Gs          , Gs^Fds      , Gs          , Re          , Re          , Re          , Gs^Fds      , Gg          , Gg          , Gg          , Gg          , Gg          , Gg          , Gg          , Gs^Fds      , Gs^Fms      , Gs^Fds      , Re          , Gg          , Hh          , Hh          , Hh          , Hh          , Hh          , Hh          , Hh          , Gs^Fds      , Gs^Fms      , Gs^Fds      , Gs^Fms      , Gg          , Gg          , Gg          , Gg          , Gg          
Gg          , Gg          , Gg          , Gg          , Gs^Fds      , Gs^Fds      , Gs^Fds      , Gs^Fds      , Gs^Fds      , Gs^Fds      , Gs^Fds      , Re          , Gs          , Gs^Fds      , Gg          , Gg          , Gg          , Gg          , Gg          , Gg          , Gs^Fds      , Gs^Fds      , Gs^Fds      , Gs^Fms      , Re          , Gg          , Hh          , Hh          , Hh          , Hh          , Hh          , Hh          , Hh          , Gs^Fds      , Gs^Fds      , Gs^Fms      , Gs^Fms      , Gg          , Gg          , Gg          , Gg          , Gg          
