border_size=1
usage=map

Mm          , Mm          , Mm          , Mm          , Mm          , Mm          , Mm          , Mm          , Gs^Fp       , Gs^Fp       , Gs^Fp       , Gg          , Gg          , Gg          , Gg          , Gg          , Gg          , Gg          , Gg          , Gg          , Gg          , Gg          , Gg          , Mm          , Mm          , Mm          , Gg          , Gg          , Gg          , Gg          , Re          , Re          , Gg          , Mm          , Hh          , Mm          , Hh          , Hh          , Hh          , Hh          , Gg          , Gg          
Mm          , Mm          , Mm          , Mm          , Mm          , Mm          , Mm          , Mm          , Gs^Fp       , Gs^Fp       , Gs^Fp       , Gg          , Gg          , Gg          , Gg          , Gg          , Gg          , Gg          , Gg          , Gg          , Gg          , Gg          , Gg          , Mm          , Mm          , Mm          , Gg          , Gg          , Gg          , Gg          , Gg          , Gg          , Gg          , Mm          , Hh^Vhh      , Mm          , Hh          , Hh          , Hh          , Hh          , Gg          , Gg          
Mm          , Mm          , Mm          , Mm          , Hh          , Hh          , Hh          , Hh          , Hh          , Gs^Fp       , Gs^Fp       , Gg          , Gg          , Gg          , Gs^Fdw      , Gg          , Gg          , Gg          , Re          , Gg          , Gg          , Gg          , Gg          , Gs^Fmw      , Gs^Fmw      , Gs^Fdw      , Gg          , Gg          , Gg          , Gg          , Gg          , Gg          , Gs^Fmw      , Hh          , Hh          , Hh          , Hh          , Hh          , Gs^Fp       , Gg          , Ww          , Ww          
Hh          , Hh          , Hh          , Hh          , Hh          , Hh          , Hh          , Hh          , Gs^Fp       , Gs^Fp       , Gg          , Gg          , Gg          , Gs^Fdw      , Gs^Fdw      , Gs^Fdw      , Gs^Fmw      , Gs^Fmw      , Gs^Fmw      , Rd          , Gs^Fmw      , Gg          , Gs^Fdw      , Gg          , Gg          , Gg          , Hh          , Gg          , Gg          , Gg          , Gg          , Gs^Fp       , Gs^Fmw      , Gs^Fdw      , Gs^Fdw      , Gs^Fdw      , Gs^Fmw      , Gs^Fmw      , Gg          , Ww          , Ww          , Ww          
Hh          , Hh          , Hh          , Hh          , Gg          , Gs^Fp       , Gs^Fp       , Gs^Fp       , Gs^Fp       , Gs^Fp       , Gg          , Gg          , Gg          , Gs^Fdw      , Gs^Fdw      , Gs^Fdw      , Gs^Fmw      , Gs^Fdw      , Gs^Fdw      , Gs^Fdw      , Gs^Fdw      , Gs^Fmw      , Gs^Fdw      , Gs^Fmw      , Gg          , Rd          , Hh          , Gs^Fp       , Gg          , Gg          , Gg          , Gs^Fp       , Gs^Fmw      , Gs^Fdw      , Gg          , Gs^Fdw      , Gg          , Gg          , Ww          , Ww          , Ww          , Ww          
Hh          , Hh          , Ww          , Gg          , Ww          , Gg          , Ww          , Gg          , Ww          , Gg          , Ww          , Gg          , Gg          , Gg          , Ww          , Gs^Fmw      , Gs^Fmw      , Gs^Fmw      , Gg          , Gs^Fdw      , Gg          , Gs^Fmw      , Gs^Fmw      , Gs^Fmw      , Gg          , Gs^Fmw      , Gs^Fmw      , Gs^Fp       , Gg          , Gg          , Gg          , Gg          , Gg          , Gg          , Gg          , Rd          , Ww          , Ww          , Ww          , Ww          , Ww          , Ww          
Ww          , Ww          , Wo          , Ww          , Wo          , Ww          , Wo          , Ww          , Wo          , Ww          , Wo          , Ww          , Ww          , Ww          , Ww          , Ww          , Ww          , Ww          , Ww          , Ww          , Ww          , Gg          , Gg          , Gg          , Gg          , Gg          , Ww          , Gg          , Ww          , Gg          , Gs^Fdw      , Gg          , Gg          , Gs^Fdw      , Wwf         , Ww          , Ww          , Ww          , Ww          , Ww          , Ww          , Ww          
Wo          , Wo          , Wo          , Wo          , Wo          , Wo          , Wo          , Wo          , Wo          , Wo          , Wo          , Wo          , Wo          , Wo          , Wo          , Wo          , Wo          , Ww          , Wo          , Wo          , Wo          , Ww          , Ww          , Ww          , Ww          , Ww          , Wo          , Ww          , Wo          , Ww          , Ww          , Ww          , Wwf         , Ww          , Wwf         , Wwf         , Ww          , Ww          , Ww          , Ww          , Ww          , Ww          
Wo          , Wo          , Ww          , Wo          , Ww          , Wo          , Ww          , Wo          , Ww          , Wo          , Ww          , Wo          , Wo          , Wo          , Wo          , Wo          , Wo          , Wo          , Gs^Fmw      , Gs^Fmw      , Gs^Fmw      , Wo          , Wo          , Wo          , Wo          , Wo          , Wo          , Wo          , Wo          , Wo          , Wo          , Ww          , Ww          , Wwf         , Ww          , Wwf         , Ww          , Ww          , Ww          , Ww          , Ww          , Ww          
Ww          , Ww          , Hh          , Ww          , Gg          , Ww          , Gs^Fmw      , Ww          , Gs^Fmw      , Ww          , Ww          , Ww          , Ww          , Ww          , Ww          , Ww          , Ww          , Wo          , Wo          , Gs^Fmw      , Wo          , Gg          , Wo          , Wo          , Wo          , Wo          , Ww          , Wo          , Ww          , Ww          , Ww          , Ww          , Ww          , Wwf         , Wwf         , Wwf         , Ww          , Ww          , Ww          , Ww          , Ww          , Ww          
Hh          , Hh          , Hh          , Gg          , Gs          , Gg          , Gs          , Gs^Fmw      , Gs          , Gs^Fdw      , Gs^Fmw      , Gs^Fmw      , Gs^Fmw      , Gg          , Gg          , Gg          , Gg          , Ww          , Ww          , Ww          , Ww          , Ww          , Ww          , Ww          , Ww          , Ww          , Ww          , Ww          , Ww          , Ww          , Ww          , Ww          , Wwf         , Wwf         , Wwf         , Wwf         , Wwf         , Ww          , Ww          , Ww          , Ww          , Ww          
Hh          , Hh          , Gs^Fdw      , Gs          , Re          , Gs          , Re          , Gs          , Re          , Gs^Fdw      , Gs^Fdw      , Gs^Fdw      , Gs^Fdw      , Re^Gvs      , Re^Gvs      , Re^Gvs      , Re^Gvs      , Gg          , Gg          , Gg          , Gg          , Gg          , Gg          , Gg^Vh       , Gg          , Gg          , Gg          , Ww          , Gg          , Ww          , Ce          , Ww          , Gg          , Ww          , Wwf         , Wwf         , Ww          , Ww          , Gg          , Gg          , Gg          , Gg          
Gs          , Gs          , Re          , Gs          , Re          , Re          , Rd          , Re          , Re          , Re          , Gs          , Gs^Fdw      , Gg          , Re^Gvs      , Re^Gvs      , Re^Gvs      , Gs^Fdw      , Gs^Fdw      , Gs^Fdw      , Re^Gvs      , Re^Gvs      , Re^Gvs      , Gg          , Re^Gvs      , Gg^Vh       , Re^Gvs      , Gg          , Gg          , Ce          , Ce          , Ce          , Ce          , Re          , Gg          , Gg          , Ww          , Gg          , Gg          , Gs^Fdw      , Re          , Re          , Gg          
Gs          , Re          , Rd          , Re          , Re          , Re          , Re          , Rd          , Re          , Re          , Re          , Re          , Gs          , Gg          , Gg          , Re^Gvs      , Gs^Fdw      , Gs^Fdw      , Gs^Fdw      , Re^Gvs      , Gg          , Gg          , Re          , Gg          , Re          , Gg          , Re          , Ce          , Re          , Ce          , Ce          , Ce          , Ce          , Ce          , Gg          , Gg          , Re          , Gs^Fdw      , Rd          , Gs^Fdw      , Re          , Re          
Gs          , Re          , Re          , Re          , Gs^Fmw      , Re          , Rd          , Re          , Re          , Rd          , Rd          , Re          , Re          , Gs          , Gg          , Gg          , Gg          , Gs^Fdw      , Re          , Gg          , Re          , Re          , Gs^Fdw      , Re          , Gg          , Re          , Gg          , Re          , Gg          , Ce          , Ce          , Ce          , Gg          , Gg          , Gg          , Re          , Re          , Rd          , Rd          , Rd          , Re          , Re          
Gg          , Ss          , Ww          , Gs^Fmw      , Ss          , Gs^Fmw      , Re          , Re          , Re          , Re          , Re          , Rd          , Re          , Gs          , Re          , Re          , Re          , Re          , Gg          , Re          , Gg          , Gs^Fdw      , Gs^Fdw      , Gs^Fdw      , Gg          , Re          , Gg          , Gg          , Re^Gvs      , Re^Gvs      , Gs^Fdw      , Gs^Fdw      , Gs^Fdw      , Gs^Fdw      , Gs^Fdw      , Gs^Fmw      , Gs^Fdw      , Rd          , Rd          , Rd          , Re          , Re          
Gg          , Ss          , Ss          , Ww          , Re          , Re          , Re          , Gs          , Re          , Rd          , Re          , Re          , Re          , Re          , Gs          , Gg          , Gg          , Gg          , Gg          , Gg          , Gg          , Gs^Fdw      , Gs^Fdw      , Gs^Fdw      , Gg          , Re          , Gg          , Re^Gvs      , Re^Gvs      , Gs^Fdw      , Gg          , Gs^Fdw      , Gs^Fdw      , Gs^Fdw      , Gs^Fmw      , Gg^Vh       , Gs^Fmw      , Re          , Gs^Fmw      , Re          , Re          , Gg          
Gg          , Gs          , Gs          , Ss          , Re          , Rd          , Rd          , Re          , Re          , Re          , Re          , Re          , Rd          , Re          , Gs^Fdw      , Gs^Fdw      , Gs^Fdw      , Gs^Fdw      , Gg          , Gg          , Gg          , Gg          , Gg          , Gg          , Re          , Re          , Gs^Fdw      , Re^Gvs      , Gs^Fdw      , Gs^Fdw      , Gs^Fdw      , Gs^Fdw      , Gs^Fdw      , Gs^Fdw      , Gs^Fdw      , Gs^Fdw      , Gg          , Gs^Fmw      , Gs^Fdw      , Gs^Fdw      , Gg          , Gg          
Gg          , Gs          , Gs          , Re          , Re          , Rd          , Rd          , Re          , Gs^Fdw      , Re          , Rd          , Re          , Rd          , Re          , Gs^Fdw      , Gs^Fdw      , Gs^Fdw      , Gg          , Gs^Fdw      , Gg          , Gg          , Gg          , Gs^Fdw      , Gg          , Re          , Gs^Fdw      , Gs^Fdw      , Gs^Fdw      , Gs^Fdw      , Gs^Fdw      , Gs^Fdw      , Gs^Fdw      , Gs^Fdw      , Gs^Fmw      , Gg          , Gg          , Gg          , Gs^Fdw      , Gs^Fmw      , Gs^Fdw      , Gg          , Gg          
Gg          , Gg          , Gs          , Re          , Re          , Re          , Re          , Re          , Gs          , Re          , Re          , Re          , Rd          , Re          , Gs          , Gs^Fdw      , Gg          , Gg          , Gs^Fdw      , Gg          , Gg          , Gs^Fdw      , Gs^Fmw      , Gs^Fmw      , Re          , Gs^Fdw      , Gs^Fdw      , Gs^Fdw      , Hh          , Gs^Fdw      , Gg          , Gs^Fdw      , Gs^Fdw      , Gs^Fdw      , Gs^Fdw      , Gs^Fdw      , Gs^Fmw      , Gg          , Gg          , Gg          , Gg          , Gg          
Gg          , Gg          , Gg          , Gs          , Gs^Fdw      , Gs          , Gs^Fdw      , Gs          , Gs^Fdw      , Gs          , Re          , Re          , Re          , Gs^Fdw      , Gg          , Gg          , Gg          , Gg          , Gg          , Gg          , Gg          , Gs^Fdw      , Gs^Fmw      , Gs^Fdw      , Re          , Gg          , Hh          , Hh          , Hh          , Hh          , Hh          , Hh          , Hh          , Gs^Fdw      , Gs^Fmw      , Gs^Fdw      , Gs^Fmw      , Gg          , Gg          , Gg          , Gg          , Gg          
Gg          , Gg          , Gg          , Gg          , Gs^Fdw      , Gs^Fdw      , Gs^Fdw      , Gs^Fdw      , Gs^Fdw      , Gs^Fdw      , Gs^Fdw      , Re          , Gs          , Gs^Fdw      , Gg          , Gg          , Gg          , Gg          , Gg          , Gg          , Gs^Fdw      , Gs^Fdw      , Gs^Fdw      , Gs^Fmw      , Re          , Gg          , Hh          , Hh          , Hh          , Hh          , Hh          , Hh          , Hh          , Gs^Fdw      , Gs^Fdw      , Gs^Fmw      , Gs^Fmw      , Gg          , Gg          , Gg          , Gg          , Gg          
