border_size=1
usage=map

Ms          , Ms          , Ms          , Ms          , Ms          , Ms          , Ms          , Ms          , Aa^Fpa      , Aa^Fpa      , Aa^Fpa      , Aa          , Aa          , Aa          , Aa          , Aa          , Aa          , Aa          , Aa          , Aa          , Aa          , Aa          , Aa          , Ms          , Ms          , Ms          , Aa          , Aa          , Aa          , Aa          , Aa          , Aa          , Aa          , Ms          , Ha          , Ms          , Ha          , Ha          , Ha          , Ha          , Aa          , Gg          
Ms          , Ms          , Ms          , Ms          , Ms          , Ms          , Ms          , Ms          , Aa^Fpa      , Aa^Fpa      , Aa^Fpa      , Aa          , Aa          , Aa          , Aa          , Aa          , Aa          , Aa          , Aa          , Aa          , Aa          , Aa          , Aa          , Ms          , Ms          , Ms          , Aa          , Aa          , Aa          , Aa          , Aa          , Aa          , Aa          , Ms          , Ha^Vhha     , Ms          , Ha          , Ha          , Ha          , Ha          , Aa          , Gg          
Ms          , Ms          , Ms          , Ms          , Ha          , Ha          , Ha          , Ha          , Ha          , Aa^Fpa      , Aa^Fpa      , Aa          , Aa          , Aa          , Aa^Fda      , Aa          , Aa          , Aa          , Aa          , Aa          , Aa          , Aa          , Aa          , Aa^Fma      , Aa^Fma      , Aa^Fda      , Aa          , Aa          , Aa          , Aa          , Aa          , Aa          , Aa^Fma      , Ha          , Ha          , Ha          , Ha          , Ha          , Aa^Fpa      , Aa          , Ai          , Ai          
Ha          , Ha          , Ha          , Ha          , Ha          , Ha          , Ha          , Ha          , Aa^Fpa      , Aa^Fpa      , Aa          , Aa          , Aa          , Aa^Fda      , Aa^Fda      , Aa^Fda      , Aa^Fma      , Aa^Fma      , Aa^Fma      , Aa          , Aa^Fma      , Aa          , Aa^Fda      , Aa          , Aa          , Aa          , Ha          , Aa          , Aa          , Aa          , Aa          , Aa^Fpa      , Aa^Fma      , Aa^Fda      , Aa^Fda      , Aa^Fda      , Aa^Fma      , Aa^Fma      , Aa          , Ai          , Ai          , Ai          
Ha          , Ha          , Ha          , Ha          , Aa          , Aa^Fpa      , Aa^Fpa      , Aa^Fpa      , Aa^Fpa      , Aa^Fpa      , Aa          , Aa          , Aa          , Aa^Fda      , Aa^Fda      , Aa^Fda      , Aa^Fma      , Aa^Fda      , Aa^Fda      , Aa^Fda      , Aa^Fda      , Aa^Fma      , Aa^Fda      , Aa^Fma      , Aa          , Aa          , Ha          , Aa^Fpa      , Aa          , Aa          , Aa          , Aa^Fpa      , Aa^Fma      , Aa^Fda      , Aa          , Aa^Fda      , Aa          , Aa          , Ai          , Ai          , Ai          , Ai          
Ha          , Ha          , Ai          , Aa          , Ai          , Aa          , Ai          , Aa          , Ai          , Aa          , Ai          , Aa          , Aa          , Aa          , Ai          , Aa^Fma      , Aa^Fma      , Aa^Fma      , Aa          , Aa^Fda      , Aa          , Aa^Fma      , Aa^Fma      , Aa^Fma      , Aa          , Aa^Fma      , Aa^Fma      , Aa^Fpa      , Aa          , Aa          , Aa          , Aa          , Aa          , Aa          , Aa          , Aa          , Ai          , Ai          , Ai          , Ai          , Ai          , Ai          
Ai          , Ai          , Wo          , Ai          , Wo          , Ai          , Wo          , Ai          , Wo          , Ai          , Wo          , Ai          , Ai          , Ai          , Ai          , Ai          , Ai          , Ai          , Ai          , Ai          , Ai          , Aa          , Aa          , Aa          , Aa          , Aa          , Ai          , Aa          , Ai          , Aa          , Aa^Fda      , Aa          , Aa          , Aa^Fda      , Aa          , Ai          , Ai          , Ai          , Ai          , Ai          , Ai          , Ai          
Wo          , Wo          , Wo          , Wo          , Wo          , Wo          , Wo          , Wo          , Wo          , Wo          , Wo          , Wo          , Wo          , Wo          , Wo          , Wo          , Wo          , Ai          , Wo          , Wo          , Wo          , Ai          , Ai          , Ai          , Ai          , Ai          , Wo          , Ai          , Wo          , Ai          , Ai          , Ai          , Aa          , Ai          , Aa          , Aa          , Ai          , Ai          , Ai          , Ai          , Ai          , Ai          
Wo          , Wo          , Ai          , Wo          , Ai          , Wo          , Ai          , Wo          , Ai          , Wo          , Ai          , Wo          , Wo          , Wo          , Wo          , Wo          , Wo          , Wo          , Aa^Fma      , Aa^Fma      , Aa^Fma      , Wo          , Wo          , Wo          , Wo          , Wo          , Wo          , Wo          , Wo          , Wo          , Wo          , Ai          , Ai          , Aa          , Ai          , Aa          , Ai          , Ai          , Ai          , Ai          , Ai          , Ai          
Ai          , Ai          , Ha          , Ai          , Aa          , Ai          , Aa^Fma      , Ai          , Aa^Fma      , Ai          , Ai          , Ai          , Ai          , Ai          , Ai          , Ai          , Ai          , Wo          , Wo          , Aa^Fma      , Wo          , Aa          , Wo          , Wo          , Wo          , Wo          , Ai          , Wo          , Ai          , Ai          , Ai          , Ai          , Ai          , Aa          , Aa          , Aa          , Ai          , Ai          , Ai          , Ai          , Ai          , Ai          
Ha          , Ha          , Ha          , Aa          , Aa          , Aa          , Aa          , Aa^Fma      , Aa          , Aa^Fda      , Aa^Fma      , Aa^Fma      , Aa^Fma      , Aa          , Aa          , Aa          , Aa          , Ai          , Ai          , Ai          , Ai          , Ai          , Ai          , Ai          , Ai          , Ai          , Ai          , Ai          , Ai          , Ai          , Ai          , Ai          , Aa          , Aa          , Aa          , Aa          , Aa          , Ai          , Ai          , Ai          , Ai          , Ai          
Ha          , Ha          , Aa^Fda      , Aa          , Aa          , Aa          , Aa          , Aa          , Aa          , Aa^Fda      , Aa^Fda      , Aa^Fda      , Aa^Fda      , Aa          , Aa          , Aa          , Aa          , Aa          , Aa          , Aa          , Aa          , Aa          , Aa          , Aa          , Aa          , Aa          , Aa          , Ai          , Aa          , Ai          , Ce          , Ai          , Aa          , Ai          , Aa          , Aa          , Ai          , Ai          , Aa          , Aa          , Aa          , Aa          
Aa          , Aa          , Aa          , Aa          , Aa          , Aa          , Aa          , Aa          , Aa          , Aa          , Aa          , Aa^Fda      , Aa          , Aa          , Aa          , Aa          , Aa^Fda      , Aa^Fda      , Aa^Fda      , Aa          , Aa          , Aa          , Aa          , Aa          , Aa          , Aa          , Aa          , Aa          , Ce          , Ce          , Ce          , Ce          , Aa          , Aa          , Aa          , Ai          , Aa          , Aa          , Aa^Fda      , Aa          , Aa          , Aa          
Aa          , Aa          , Aa          , Aa          , Aa          , Aa          , Aa          , Aa          , Aa          , Aa          , Aa          , Aa          , Aa          , Aa          , Aa          , Aa          , Aa^Fda      , Aa^Fda      , Aa^Fda      , Aa          , Aa          , Aa          , Aa          , Aa          , Aa          , Aa          , Aa          , Ce          , Aa          , Ce          , Ce          , Ce          , Ce          , Ce          , Aa          , Aa          , Aa          , Aa^Fda      , Aa          , Aa^Fda      , Aa          , Aa          
Aa          , Aa          , Aa          , Aa          , Aa^Fma      , Aa          , Aa          , Aa          , Aa          , Aa          , Aa          , Aa          , Aa          , Aa          , Aa          , Aa          , Aa          , Aa^Fda      , Aa          , Aa          , Aa          , Aa          , Aa^Fda      , Aa          , Aa          , Aa          , Aa          , Aa          , Aa          , Ce          , Ce          , Ce          , Aa          , Aa          , Aa          , Aa          , Aa          , Aa          , Aa          , Aa          , Aa          , Aa          
Aa          , Aa          , Ai          , Aa^Fma      , Ai          , Aa^Fma      , Aa          , Aa          , Aa          , Aa          , Aa          , Aa          , Aa          , Aa          , Aa          , Aa          , Aa          , Aa          , Aa          , Aa          , Aa          , Aa^Fda      , Aa^Fda      , Aa^Fda      , Aa          , Aa          , Aa          , Aa          , Aa          , Aa          , Aa^Fda      , Aa^Fda      , Aa^Fda      , Aa^Fda      , Aa^Fda      , Aa^Fma      , Aa^Fda      , Aa          , Aa          , Aa          , Aa          , Aa          
Aa          , Aa          , Ai          , Ai          , Aa          , Aa          , Aa          , Aa          , Aa          , Aa          , Aa          , Aa          , Aa          , Aa          , Aa          , Aa          , Aa          , Aa          , Aa          , Aa          , Aa          , Aa^Fda      , Aa^Fda      , Aa^Fda      , Aa          , Aa          , Aa          , Aa          , Aa          , Aa^Fda      , Aa          , Aa^Fda      , Aa^Fda      , Aa^Fda      , Aa^Fma      , Aa          , Aa^Fma      , Aa          , Aa^Fma      , Aa          , Aa          , Aa          
Aa          , Aa          , Aa          , Aa          , Aa          , Aa          , Aa          , Aa          , Aa          , Aa          , Aa          , Aa          , Aa          , Aa          , Aa^Fda      , Aa^Fda      , Aa^Fda      , Aa^Fda      , Aa          , Aa          , Aa          , Aa          , Aa          , Aa          , Aa          , Aa          , Aa^Fda      , Aa          , Aa^Fda      , Aa^Fda      , Aa^Fda      , Aa^Fda      , Aa^Fda      , Aa^Fda      , Aa^Fda      , Aa^Fda      , Aa          , Aa^Fma      , Aa^Fma      , Aa^Fda      , Aa          , Aa          
Aa          , Aa          , Aa          , Aa          , Aa          , Aa          , Aa          , Aa          , Aa^Fda      , Aa          , Aa          , Aa          , Aa          , Aa          , Aa^Fda      , Aa^Fda      , Aa^Fda      , Aa          , Aa^Fda      , Aa          , Aa          , Aa          , Aa^Fda      , Aa          , Aa          , Aa^Fda      , Aa^Fda      , Aa^Fda      , Aa^Fda      , Aa^Fda      , Aa^Fda      , Aa^Fda      , Aa^Fda      , Aa^Fma      , Aa          , Aa          , Aa          , Aa^Fda      , Aa^Fma      , Aa^Fda      , Aa          , Aa          
Aa          , Aa          , Aa          , Aa          , Aa          , Aa          , Aa          , Aa          , Aa          , Aa          , Aa          , Aa          , Aa          , Aa          , Aa          , Aa^Fda      , Aa          , Aa          , Aa^Fda      , Aa          , Aa          , Aa^Fda      , Aa^Fma      , Aa^Fma      , Aa          , Aa^Fda      , Aa^Fda      , Aa^Fda      , Ha          , Aa^Fda      , Aa          , Aa^Fda      , Aa^Fda      , Aa^Fda      , Aa^Fda      , Aa^Fda      , Aa^Fma      , Aa          , Aa          , Aa          , Aa          , Aa          
Aa          , Aa          , Aa          , Aa          , Aa^Fda      , Aa          , Aa^Fda      , Aa          , Aa^Fda      , Aa          , Aa          , Aa          , Aa          , Aa^Fda      , Aa          , Aa          , Aa          , Aa          , Aa          , Aa          , Aa          , Aa^Fda      , Aa^Fma      , Aa^Fda      , Aa          , Aa          , Ha          , Ha          , Ha          , Ha          , Ha          , Ha          , Ha          , Aa^Fda      , Aa^Fma      , Aa^Fda      , Aa^Fma      , Aa          , Aa          , Aa          , Aa          , Aa          
Aa          , Aa          , Aa          , Aa          , Aa^Fda      , Aa^Fda      , Aa^Fda      , Aa^Fda      , Aa^Fda      , Aa^Fda      , Aa^Fda      , Aa          , Aa          , Aa^Fda      , Aa          , Aa          , Aa          , Aa          , Aa          , Aa          , Aa^Fda      , Aa^Fda      , Aa^Fda      , Aa^Fma      , Aa          , Aa          , Ha          , Ha          , Ha          , Ha          , Ha          , Ha          , Ha          , Aa^Fda      , Aa^Fda      , Aa^Fma      , Aa^Fma      , Aa          , Aa          , Aa          , Aa          , Aa          
