border_size=1
usage=map

Mm          , Mm          , Mm          , Mm          , Mm          , Mm          , Mm          , Mm          , Gs^Fp       , Gs^Fp       , Gs^Fp       , Gs          , Gs          , Gs          , Gs          , Gs          , Gs          , Gs          , Gs          , Gs          , Gs          , Gs          , Gs          , Mm          , Mm          , Mm          , Gs          , Gs          , Gs          , Re          , Rd          , Rd          , Re          , Mm          , Hh          , Mm          , Hh          , Hh          , Hh          , Hh          , Gs          , Gs          
Mm          , Mm          , Mm          , Mm          , Mm          , Mm          , Mm          , Mm          , Gs^Fp       , Gs^Fp       , Gs^Fp       , Gs          , Gs          , Gs          , Gs          , Gs          , Gs          , Gs          , Gs          , Gs          , Gs          , Gs          , Gs          , Mm          , Mm          , Mm          , Gs          , Gs          , Gs          , Re          , Re          , Re          , Gs          , Mm          , Hh^Vhh      , Mm          , Hh          , Hh          , Hh          , Hh          , Ss          , Ss          
Mm          , Mm          , Mm          , Mm          , Hh          , Hh          , Hh          , Hh          , Hh          , Gs^Fp       , Gs^Fp       , Gs          , Gs          , Gs          , Gs^Fdw      , Gs          , Gs          , Gs          , Re          , Re          , Re          , Gs          , Gs          , Gs^Fmw      , Gs^Fmw      , Gs^Fdw      , Gs          , Gs          , Gs          , Gs          , Gs          , Gs          , Gs^Fmw      , Hh          , Hh          , Hh          , Hh          , Hh          , Gs^Fp       , Ss          , Ww          , Ww          
Hh          , Hh          , Hh          , Hh          , Hh          , Hh          , Hh          , Hh          , Gs^Fp       , Gs^Fp       , Gs          , Gs          , Gs          , Gs^Fdw      , Gs^Fdw      , Gs^Fdw      , Gs^Fmw      , Gs^Fmw      , Gs^Fmw      , Rd          , Gs^Fmw      , Gs          , Gs^Fdw      , Gs          , Re          , Re          , Hh          , Gs          , Gs          , Gs          , Gs          , Gs^Fp       , Gs^Fmw      , Gs^Fdw      , Gs^Fdw      , Gs^Fdw      , Gs^Fmw      , Gs^Fmw      , Ss          , Ww          , Ww          , Ww          
Hh          , Hh          , Hh          , Hh          , Gs          , Gs^Fp       , Gs^Fp       , Gs^Fp       , Gs^Fp       , Gs^Fp       , Gs          , Gs          , Gs          , Gs^Fdw      , Gs^Fdw      , Gs^Fdw      , Gs^Fmw      , Gs^Fdw      , Gs^Fdw      , Gs^Fdw      , Gs^Fdw      , Gs^Fmw      , Gs^Fdw      , Gs^Fmw      , Re          , Rd          , Hh          , Gs^Fp       , Gs          , Gs          , Gs          , Gs^Fp       , Gs^Fmw      , Gs^Fdw      , Re          , Gs^Fdw      , Re          , Ss          , Ww          , Ww          , Ww          , Ww          
Hh          , Hh          , Ww          , Gs          , Ww          , Gs          , Ww          , Gs          , Ww          , Gs          , Ww          , Gs          , Gs          , Gs          , Ww          , Gs^Fmw      , Gs^Fmw      , Gs^Fmw      , Gs          , Gs^Fdw      , Gs          , Gs^Fmw      , Gs^Fmw      , Gs^Fmw      , Gs          , Gs^Fmw      , Gs^Fmw      , Gs^Fp       , Gs          , Gs          , Gs          , Gs          , Gs          , Gs          , Re          , Rd          , Ww          , Ww          , Ww          , Ww          , Ww          , Ww          
Ww          , Ww          , Wo          , Ww          , Wo          , Ww          , Wo          , Ww          , Wo          , Ww          , Wo          , Ww          , Ww          , Ww          , Ww          , Ww          , Ww          , Ww          , Ww          , Ww          , Ww          , Gs          , Gs          , Gs          , Gs          , Gs          , Ww          , Gs          , Ww          , Gs          , Gs^Fdw      , Gs          , Gs          , Gs^Fdw      , Wwf         , Ww          , Ww          , Ww          , Ww          , Ww          , Ww          , Ww          
Wo          , Wo          , Wo          , Wo          , Wo          , Wo          , Wo          , Wo          , Wo          , Wo          , Wo          , Wo          , Wo          , Wo          , Wo          , Wo          , Wo          , Ww          , Wo          , Wo          , Wo          , Ww          , Ww          , Ww          , Ww          , Ww          , Wo          , Ww          , Wo          , Ww          , Ww          , Wwf         , Rr          , Ww          , Wwf         , Wwf         , Ww          , Ww          , Ww          , Ww          , Ww          , Ww          
Wo          , Wo          , Ww          , Wo          , Ww          , Wo          , Ww          , Wo          , Ww          , Wo          , Ww          , Wo          , Wo          , Wo          , Wo          , Wo          , Wo          , Wo          , Gs^Fmw      , Gs^Fmw      , Gs^Fmw      , Wo          , Wo          , Wo          , Wo          , Wo          , Wo          , Wo          , Wo          , Wo          , Wo          , Ww          , Wwf         , Wwf         , Ww          , Wwf         , Ww          , Ww          , Ww          , Ww          , Ww          , Ww          
Ww          , Ww          , Hh          , Ww          , Gs          , Ww          , Gs^Fmw      , Ww          , Gs^Fmw      , Ww          , Ww          , Ww          , Ww          , Ww          , Ww          , Ww          , Ww          , Wo          , Wo          , Gs^Fmw      , Wo          , Gs          , Wo          , Wo          , Wo          , Wo          , Ww          , Wo          , Ww          , Ww          , Ww          , Ww          , Ww          , Wwf         , Wwf         , Wwf         , Ww          , Ww          , Ww          , Ww          , Ww          , Ww          
Hh          , Hh          , Hh          , Gs          , Re          , Gs          , Re          , Gs^Fmw      , Re          , Gs^Fdw      , Gs^Fmw      , Gs^Fmw      , Gs^Fmw      , Gs          , Gs          , Gs          , Gs          , Ww          , Ww          , Ww          , Ww          , Ww          , Ww          , Ww          , Ww          , Ww          , Ww          , Ww          , Ww          , Ww          , Ww          , Ww          , Wwf         , Wwf         , Wwf         , Wwf         , Wwf         , Ww          , Ww          , Ww          , Ww          , Ww          
Hh          , Hh          , Gs^Fdw      , Re          , Rd          , Re          , Rd          , Re          , Rd          , Gs^Fdw      , Gs^Fdw      , Gs^Fdw      , Gs^Fdw      , Re^Gvs      , Re^Gvs      , Re^Gvs      , Re^Gvs      , Gs          , Gs          , Gs          , Gs          , Gs          , Gs          , Gs          , Gs          , Gs          , Gs          , Ww          , Wwf         , Ww          , Wwf         , Ww          , Wwf         , Ww          , Wwf         , Wwf         , Ww          , Ww          , Ss          , Ss          , Ss          , Ss          
Re          , Re          , Rd          , Re          , Rd          , Rd          , Rr          , Rd          , Rd          , Rd          , Re          , Gs^Fdw      , Re          , Re^Gvs      , Re^Gvs      , Re^Gvs      , Gs^Fdw      , Gs^Fdw      , Gs^Fdw      , Re^Gvs      , Re^Gvs      , Re^Gvs      , Re          , Re^Gvs      , Re          , Re^Gvs      , Re          , Re          , Rd          , Wwf         , Ww          , Wwf         , Rd          , Re          , Re          , Ww          , Ss          , Ss          , Gs^Fdw      , Ss          , Rd          , Re          
Re          , Rd          , Rr          , Rd          , Rd          , Rd          , Rd          , Rr          , Rd          , Rd          , Rd          , Rd          , Re          , Gs          , Gs          , Re^Gvs      , Gs^Fdw      , Gs^Fdw      , Gs^Fdw      , Re^Gvs      , Re          , Re          , Rd          , Re          , Rd          , Re          , Rd          , Rd          , Rd          , Rr          , Rr          , Rr          , Rd          , Rd          , Re          , Re          , Rd          , Gs^Fdw      , Rr          , Gs^Fdw      , Rd          , Rd          
Re          , Rd          , Rd          , Rd          , Gs^Fmw      , Rd          , Rr          , Rd          , Rd          , Rr          , Rr          , Rd          , Rd          , Re          , Re          , Re          , Re          , Gs^Fdw      , Rd          , Re          , Rd          , Rd          , Gs^Fdw      , Rd          , Re          , Rd          , Re          , Rd          , Re          , Rd          , Rd          , Rd          , Re          , Re          , Re          , Rd          , Rd          , Rr          , Rr          , Rr          , Rd          , Rd          
Gs          , Ss          , Ww          , Gs^Fmw      , Ss          , Gs^Fmw      , Rd          , Rd          , Rd          , Rd          , Rd          , Rr          , Rd          , Re          , Rd          , Rd          , Rd          , Rd          , Re          , Rd          , Re          , Gs^Fdw      , Gs^Fdw      , Gs^Fdw      , Re          , Rd          , Re          , Re          , Re^Gvs      , Re^Gvs      , Gs^Fdw      , Gs^Fdw      , Gs^Fdw      , Gs^Fdw      , Gs^Fdw      , Gs^Fmw      , Gs^Fdw      , Rr          , Rr          , Rr          , Rd          , Rd          
Gs          , Ss          , Ss          , Ww          , Rd          , Rd          , Rd          , Re          , Rd          , Rr          , Rd          , Rd          , Rd          , Rd          , Re          , Re          , Re          , Re          , Gs          , Re          , Gs          , Gs^Fdw      , Gs^Fdw      , Gs^Fdw      , Re          , Rd          , Re          , Re^Gvs      , Re^Gvs      , Gs^Fdw      , Re          , Gs^Fdw      , Gs^Fdw      , Gs^Fdw      , Gs^Fmw      , Re          , Gs^Fmw      , Rd          , Gs^Fmw      , Rd          , Rd          , Re          
Gs          , Re          , Re          , Ss          , Rd          , Rr          , Rr          , Rd          , Rd          , Rd          , Rd          , Rd          , Rr          , Rd          , Gs^Fdw      , Gs^Fdw      , Gs^Fdw      , Gs^Fdw      , Gs          , Gs          , Gs          , Gs          , Gs          , Re          , Rd          , Rd          , Gs^Fdw      , Re^Gvs      , Gs^Fdw      , Gs^Fdw      , Gs^Fdw      , Gs^Fdw      , Gs^Fdw      , Gs^Fdw      , Gs^Fdw      , Gs^Fdw      , Re          , Gs^Fmw      , Gs^Fdw      , Gs^Fdw      , Re          , Re          
Gs          , Re          , Re          , Rd          , Rd          , Rr          , Rr          , Rd          , Gs^Fdw      , Rd          , Rr          , Rd          , Rr          , Rd          , Gs^Fdw      , Gs^Fdw      , Gs^Fdw      , Gs          , Gs^Fdw      , Gs          , Gs          , Gs          , Gs^Fdw      , Re          , Rd          , Gs^Fdw      , Gs^Fdw      , Gs^Fdw      , Gs^Fdw      , Gs^Fdw      , Gs^Fdw      , Gs^Fdw      , Gs^Fdw      , Gs^Fmw      , Gs          , Gs          , Gs          , Gs^Fdw      , Gs^Fmw      , Gs^Fdw      , Re          , Re          
Gs          , Gs          , Re          , Rd          , Rd          , Rd          , Rd          , Rd          , Re          , Rd          , Rd          , Rd          , Rr          , Rd          , Re          , Gs^Fdw      , Gs          , Gs          , Gs^Fdw      , Gs          , Gs          , Gs^Fdw      , Gs^Fmw      , Gs^Fmw      , Rd          , Gs^Fdw      , Gs^Fdw      , Gs^Fdw      , Hh          , Gs^Fdw      , Gs          , Gs^Fdw      , Gs^Fdw      , Gs^Fdw      , Gs^Fdw      , Gs^Fdw      , Gs^Fmw      , Gs          , Gs          , Gs          , Gs          , Re          
Gs          , Gs          , Gs          , Re          , Gs^Fdw      , Re          , Gs^Fdw      , Re          , Gs^Fdw      , Re          , Rd          , Rd          , Rd          , Gs^Fdw      , Re          , Re          , Gs          , Gs          , Gs          , Gs          , Gs          , Gs^Fdw      , Gs^Fmw      , Gs^Fdw      , Rd          , Re          , Hh          , Hh          , Hh          , Hh          , Hh          , Hh          , Hh          , Gs^Fdw      , Gs^Fmw      , Gs^Fdw      , Gs^Fmw      , Gs          , Gs          , Gs          , Gs          , Gs          
Gs          , Gs          , Gs          , Gs          , Gs^Fdw      , Gs^Fdw      , Gs^Fdw      , Gs^Fdw      , Gs^Fdw      , Gs^Fdw      , Gs^Fdw      , Rd          , Re          , Gs^Fdw      , Gs          , Gs          , Gs          , Gs          , Gs          , Gs          , Gs^Fdw      , Gs^Fdw      , Gs^Fdw      , Gs^Fmw      , Rd          , Re          , Hh          , Hh          , Hh          , Hh          , Hh          , Hh          , Hh          , Gs^Fdw      , Gs^Fdw      , Gs^Fmw      , Gs^Fmw      , Gs          , Gs          , Gs          , Gs          , Gs          
