border_size=1
usage=map

Mm          , Mm          , Mm          , Mm          , Mm          , Mm          , Mm          , Mm          , Gs^Fp       , Gs^Fp       , Gs^Fp       , Gs          , Gs          , Gs          , Gs          , Gs          , Gs          , Gs          , Gs          , Gs          , Gs          , Gs          , Gs          , Mm          , Mm          , Mm          , Gs          , Gs          , Gs          , Gs          , Re          , Re          , Gs          , Mm          , Hh          , Mm          , Hh          , Hh          , Hh          , Hh          , Gs          , Gs          
Mm          , Mm          , Mm          , Mm          , Mm          , Mm          , Mm          , Mm          , Gs^Fp       , Gs^Fp       , Gs^Fp       , Gs          , Gs          , Gs          , Gs          , Gs          , Gs          , Gs          , Gs          , Gs          , Gs          , Gs          , Gs          , Mm          , Mm          , Mm          , Gs          , Gs          , Gs          , Gs          , Gs          , Gs          , Gs          , Mm          , Hh^Vhh      , Mm          , Hh          , Hh          , Hh          , Hh          , Gs          , Gs          
Mm          , Mm          , Mm          , Mm          , Hh          , Hh          , Hh          , Hh          , Hh          , Gs^Fp       , Gs^Fp       , Gs          , Gs          , Gs          , Gs^Fdw      , Gs          , Gs          , Gs          , Re          , Gs          , Gs          , Gs          , Gs          , Gs^Fmw      , Gs^Fmw      , Gs^Fdw      , Gs          , Gs          , Gs          , Gs          , Gs          , Gs          , Gs^Fmw      , Hh          , Hh          , Hh          , Hh          , Hh          , Gs^Fp       , Gs          , Ww          , Ww          
Hh          , Hh          , Hh          , Hh          , Hh          , Hh          , Hh          , Hh          , Gs^Fp       , Gs^Fp       , Gs          , Gs          , Gs          , Gs^Fdw      , Gs^Fdw      , Gs^Fdw      , Gs^Fmw      , Gs^Fmw      , Gs^Fmw      , Rd          , Gs^Fmw      , Gs          , Gs^Fdw      , Gs          , Gs          , Gs          , Hh          , Gs          , Gs          , Gs          , Gs          , Gs^Fp       , Gs^Fmw      , Gs^Fdw      , Gs^Fdw      , Gs^Fdw      , Gs^Fmw      , Gs^Fmw      , Gs          , Ww          , Ww          , Ww          
Hh          , Hh          , Hh          , Hh          , Gs          , Gs^Fp       , Gs^Fp       , Gs^Fp       , Gs^Fp       , Gs^Fp       , Gs          , Gs          , Gs          , Gs^Fdw      , Gs^Fdw      , Gs^Fdw      , Gs^Fmw      , Gs^Fdw      , Gs^Fdw      , Gs^Fdw      , Gs^Fdw      , Gs^Fmw      , Gs^Fdw      , Gs^Fmw      , Gs          , Rd          , Hh          , Gs^Fp       , Gs          , Gs          , Gs          , Gs^Fp       , Gs^Fmw      , Gs^Fdw      , Gs          , Gs^Fdw      , Gs          , Gs          , Ww          , Ww          , Ww          , Ww          
Hh          , Hh          , Ww          , Gs          , Ww          , Gs          , Ww          , Gs          , Ww          , Gs          , Ww          , Gs          , Gs          , Gs          , Ww          , Gs^Fmw      , Gs^Fmw      , Gs^Fmw      , Gs          , Gs^Fdw      , Gs          , Gs^Fmw      , Gs^Fmw      , Gs^Fmw      , Gs          , Gs^Fmw      , Gs^Fmw      , Gs^Fp       , Gs          , Gs          , Gs          , Gs          , Gs          , Gs          , Gs          , Rd          , Ww          , Ww          , Ww          , Ww          , Ww          , Ww          
Ww          , Ww          , Wo          , Ww          , Wo          , Ww          , Wo          , Ww          , Wo          , Ww          , Wo          , Ww          , Ww          , Ww          , Ww          , Ww          , Ww          , Ww          , Ww          , Ww          , Ww          , Gs          , Gs          , Gs          , Gs          , Gs          , Ww          , Gs          , Ww          , Gs          , Gs^Fdw      , Gs          , Gs          , Gs^Fdw      , Wwf         , Ww          , Ww          , Ww          , Ww          , Ww          , Ww          , Ww          
Wo          , Wo          , Wo          , Wo          , Wo          , Wo          , Wo          , Wo          , Wo          , Wo          , Wo          , Wo          , Wo          , Wo          , Wo          , Wo          , Wo          , Ww          , Wo          , Wo          , Wo          , Ww          , Ww          , Ww          , Ww          , Ww          , Wo          , Ww          , Wo          , Ww          , Ww          , Ww          , Wwf         , Ww          , Wwf         , Wwf         , Ww          , Ww          , Ww          , Ww          , Ww          , Ww          
Wo          , Wo          , Ww          , Wo          , Ww          , Wo          , Ww          , Wo          , Ww          , Wo          , Ww          , Wo          , Wo          , Wo          , Wo          , Wo          , Wo          , Wo          , Gs^Fmw      , Gs^Fmw      , Gs^Fmw      , Wo          , Wo          , Wo          , Wo          , Wo          , Wo          , Wo          , Wo          , Wo          , Wo          , Ww          , Ww          , Wwf         , Ww          , Wwf         , Ww          , Ww          , Ww          , Ww          , Ww          , Ww          
Ww          , Ww          , Hh          , Ww          , Gs          , Ww          , Gs^Fmw      , Ww          , Gs^Fmw      , Ww          , Ww          , Ww          , Ww          , Ww          , Ww          , Ww          , Ww          , Wo          , Wo          , Gs^Fmw      , Wo          , Gs          , Wo          , Wo          , Wo          , Wo          , Ww          , Wo          , Ww          , Ww          , Ww          , Ww          , Ww          , Wwf         , Wwf         , Wwf         , Ww          , Ww          , Ww          , Ww          , Ww          , Ww          
Hh          , Hh          , Hh          , Gs          , Re          , Gs          , Re          , Gs^Fmw      , Re          , Gs^Fdw      , Gs^Fmw      , Gs^Fmw      , Gs^Fmw      , Gs          , Gs          , Gs          , Gs          , Ww          , Ww          , Ww          , Ww          , Ww          , Ww          , Ww          , Ww          , Ww          , Ww          , Ww          , Ww          , Ww          , Ww          , Ww          , Wwf         , Wwf         , Wwf         , Wwf         , Wwf         , Ww          , Ww          , Ww          , Ww          , Ww          
Hh          , Hh          , Gs^Fdw      , Re          , Rd          , Re          , Rd          , Re          , Rd          , Gs^Fdw      , Gs^Fdw      , Gs^Fdw      , Gs^Fdw      , Re^Gvs      , Re^Gvs      , Re^Gvs      , Re^Gvs      , Gs          , Gs          , Gs          , Gs          , Gs          , Gs          , Gg^Vh       , Gs          , Gs          , Gs          , Ww          , Gs          , Ww          , Ce          , Ww          , Gs          , Ww          , Wwf         , Wwf         , Ww          , Ww          , Gs          , Gs          , Gs          , Gs          
Re          , Re          , Rd          , Re          , Rd          , Rd          , Rr          , Rd          , Rd          , Rd          , Re          , Gs^Fdw      , Gs          , Re^Gvs      , Re^Gvs      , Re^Gvs      , Gs^Fdw      , Gs^Fdw      , Gs^Fdw      , Re^Gvs      , Re^Gvs      , Re^Gvs      , Gs          , Re^Gvs      , Gg^Vh       , Re^Gvs      , Gs          , Gs          , Ce          , Ce          , Ce          , Ce          , Rd          , Gs          , Gs          , Ww          , Gs          , Gs          , Gs^Fdw      , Rd          , Rd          , Gs          
Re          , Rd          , Rr          , Rd          , Rd          , Rd          , Rd          , Rr          , Rd          , Rd          , Rd          , Rd          , Re          , Gs          , Gs          , Re^Gvs      , Gs^Fdw      , Gs^Fdw      , Gs^Fdw      , Re^Gvs      , Gs          , Gs          , Rd          , Gs          , Rd          , Gs          , Rd          , Ce          , Rd          , Ce          , Ce          , Ce          , Ce          , Ce          , Gs          , Gs          , Rd          , Gs^Fdw      , Rr          , Gs^Fdw      , Rd          , Rd          
Re          , Rd          , Rd          , Rd          , Gs^Fmw      , Rd          , Rr          , Rd          , Rd          , Rr          , Rr          , Rd          , Rd          , Re          , Gs          , Gs          , Gs          , Gs^Fdw      , Rd          , Gs          , Rd          , Rd          , Gs^Fdw      , Rd          , Gs          , Rd          , Gs          , Rd          , Gs          , Ce          , Ce          , Ce          , Gs          , Gs          , Gs          , Rd          , Rd          , Rr          , Rr          , Rr          , Rd          , Rd          
Gs          , Ss          , Ww          , Gs^Fmw      , Ss          , Gs^Fmw      , Rd          , Rd          , Rd          , Rd          , Rd          , Rr          , Rd          , Re          , Rd          , Rd          , Rd          , Rd          , Gs          , Rd          , Gs          , Gs^Fdw      , Gs^Fdw      , Gs^Fdw      , Gs          , Rd          , Gs          , Gs          , Re^Gvs      , Re^Gvs      , Gs^Fdw      , Gs^Fdw      , Gs^Fdw      , Gs^Fdw      , Gs^Fdw      , Gs^Fmw      , Gs^Fdw      , Rr          , Rr          , Rr          , Rd          , Rd          
Gs          , Ss          , Ss          , Ww          , Rd          , Rd          , Rd          , Re          , Rd          , Rr          , Rd          , Rd          , Rd          , Rd          , Re          , Gs          , Gs          , Gs          , Gs          , Gs          , Gs          , Gs^Fdw      , Gs^Fdw      , Gs^Fdw      , Gs          , Rd          , Gs          , Re^Gvs      , Re^Gvs      , Gs^Fdw      , Gs          , Gs^Fdw      , Gs^Fdw      , Gs^Fdw      , Gs^Fmw      , Gg^Vh       , Gs^Fmw      , Rd          , Gs^Fmw      , Rd          , Rd          , Gs          
Gs          , Re          , Re          , Ss          , Rd          , Rr          , Rr          , Rd          , Rd          , Rd          , Rd          , Rd          , Rr          , Rd          , Gs^Fdw      , Gs^Fdw      , Gs^Fdw      , Gs^Fdw      , Gs          , Gs          , Gs          , Gs          , Gs          , Gs          , Rd          , Rd          , Gs^Fdw      , Re^Gvs      , Gs^Fdw      , Gs^Fdw      , Gs^Fdw      , Gs^Fdw      , Gs^Fdw      , Gs^Fdw      , Gs^Fdw      , Gs^Fdw      , Gs          , Gs^Fmw      , Gs^Fdw      , Gs^Fdw      , Gs          , Gs          
Gs          , Re          , Re          , Rd          , Rd          , Rr          , Rr          , Rd          , Gs^Fdw      , Rd          , Rr          , Rd          , Rr          , Rd          , Gs^Fdw      , Gs^Fdw      , Gs^Fdw      , Gs          , Gs^Fdw      , Gs          , Gs          , Gs          , Gs^Fdw      , Gs          , Rd          , Gs^Fdw      , Gs^Fdw      , Gs^Fdw      , Gs^Fdw      , Gs^Fdw      , Gs^Fdw      , Gs^Fdw      , Gs^Fdw      , Gs^Fmw      , Gs          , Gs          , Gs          , Gs^Fdw      , Gs^Fmw      , Gs^Fdw      , Gs          , Gs          
Gs          , Gs          , Re          , Rd          , Rd          , Rd          , Rd          , Rd          , Re          , Rd          , Rd          , Rd          , Rr          , Rd          , Re          , Gs^Fdw      , Gs          , Gs          , Gs^Fdw      , Gs          , Gs          , Gs^Fdw      , Gs^Fmw      , Gs^Fmw      , Rd          , Gs^Fdw      , Gs^Fdw      , Gs^Fdw      , Hh          , Gs^Fdw      , Gs          , Gs^Fdw      , Gs^Fdw      , Gs^Fdw      , Gs^Fdw      , Gs^Fdw      , Gs^Fmw      , Gs          , Gs          , Gs          , Gs          , Gs          
Gs          , Gs          , Gs          , Re          , Gs^Fdw      , Re          , Gs^Fdw      , Re          , Gs^Fdw      , Re          , Rd          , Rd          , Rd          , Gs^Fdw      , Gs          , Gs          , Gs          , Gs          , Gs          , Gs          , Gs          , Gs^Fdw      , Gs^Fmw      , Gs^Fdw      , Rd          , Gs          , Hh          , Hh          , Hh          , Hh          , Hh          , Hh          , Hh          , Gs^Fdw      , Gs^Fmw      , Gs^Fdw      , Gs^Fmw      , Gs          , Gs          , Gs          , Gs          , Gs          
Gs          , Gs          , Gs          , Gs          , Gs^Fdw      , Gs^Fdw      , Gs^Fdw      , Gs^Fdw      , Gs^Fdw      , Gs^Fdw      , Gs^Fdw      , Rd          , Re          , Gs^Fdw      , Gs          , Gs          , Gs          , Gs          , Gs          , Gs          , Gs^Fdw      , Gs^Fdw      , Gs^Fdw      , Gs^Fmw      , Rd          , Gs          , Hh          , Hh          , Hh          , Hh          , Hh          , Hh          , Hh          , Gs^Fdw      , Gs^Fdw      , Gs^Fmw      , Gs^Fmw      , Gs          , Gs          , Gs          , Gs          , Gs          
